   ######################
                        #
#               #       #
#        #     #        #
#   #     #             #
#                       #
#                       #
#########################
