####################
#                  #
#                  #
#  ##  ##  ##  ##  #
#  ##  ##  ##  ##  #
#                  #
#                  #
#  ##  ##  ##  ##  #
#  ##  ##  ##  ##  #
#                  #
#                  #
#  ##  ##  ##  ##  #
#  ##  ##  ##  ##  #
#                  #
#                  #
#  ##  ##  ##  ##  #
#  ##  ##  ##  ##  #
#                  #
#                  #
####################
